Alabama	AL
Ala	AL
Alaska	AK
Arizona	AZ
Ariz	AZ
Arkansas	AR
Ark	AR
California	CA
Calif	CA
Colorado	CO
Colo	CO
Connecticut	CT
Conn	CT
Delaware	DE
Del	DE
District of Columbia	DC
Florida	FL
Fla	FL
Georgia	GA
Hawaii	HI
Idaho	ID
Illinois	IL
Ill	IL
Indiana	IN
Iowa	IA
Kansas	KS
Kans	KS
Kentucky	KY
Louisiana	LA
Maine	ME
Maryland	MD
Massachusetts	MA
Mass	MA
Michigan	MI
Mich	MI
Minnesota	MN
Minn	MN
Mississippi	MS
Miss	MS
Missouri	MO
Montana	MT
Mont	MT
Nebraska	NE
Nebr	NE
Nevada	NV
Nev	NV
New Hampshire	NH
New Jersey	NJ
New Mexico	NM
New York	NY
North Carolina	NC
N Carolina	NC
North Dakota	ND
N Dakota	ND
Ohio	OH
Oklahoma	OK
Okla	OK
Oregon	OR
Ore	OR
Pennsylvania	PA
Penn	PA
Rhode Island	RI
South Carolina	SC
S Carolina	SC
South Dakota	SD
S Dakota	SD
Tennessee	TN
Tenn	TN
Texas	TX
Tex	TX
Utah	UT
Vermont	VT
Virginia	VA
Washington	WA
Washington State	WA
Wash	WA
West Virginia	WV
WVa	WV
W Va	WV
Wisconsin	WI
Wis	WI
Wisc	WI
Wyoming	WY
Wyo	WY
